####################
#..................#
#..................#
#..................#
#..................#
#..................#
#..................#
#.>.--@............#
#..................#
#..................#
#..................#
#..................#
#..................#
#..................#
####################
