####...###...####...###...####
#............................#
#............................#
#............................#
#......#####......#####......#
#......#..............#......#
.......#..............#.......
.......#..............#.......
.......#..............#.......
#......#..............#......#
#......#..............#......#
#.....--@....................#
#............................#
#............####............#
.............####.............
.............####.............
#............####............#
#............................#
#............................#
#......#..............#......#
#......#..............#......#
.......#..............#.......
.......#..............#.......
.......#..............#.......
#......#..............#......#
#......#####......#####......#
#............................#
#............................#
#............................#
####...###...####...###...####