..............................
..............................
...#######..........#######...
...#.....#..........#.....#...
...#.....#..........#.....#...
...#.....#..........#.....#...
...#.....#..........#.....#...
...#.....#..........#.....#...
...#.....#..........#.....#...
...#######..........#######...
..............................
......--@.....................
..............................
..............................
..............................
..............................
..............................
..............................
..............................
..............................
...#######..........#######...
...#.....#..........#.....#...
...#.....#..........#.....#...
...#.....#..........#.....#...
...#.....#..........#.....#...
...#.....#..........#.....#...
...#.....#..........#.....#...
...#######..........#######...
..............................
..............................