..............................
..............................
.........#..........#.........
.........#..........#.........
.........#..........#.........
.........#..........#.........
.........#..........#.........
.........#..........#.........
.........#..........#.........
..########..........########..
..............................
......--@.....................
..............................
..............................
..............................
..............................
..............................
..............................
..............................
..............................
..########..........########..
.........#..........#.........
.........#..........#.........
.........#..........#.........
.........#..........#.........
.........#..........#.........
.........#..........#.........
.........#..........#.........
..............................
..............................